XXXXXX
XX** X
XXX  X
X O  X
X O XX
XP  XX
XXXXXX